BANANA=AMARELO
MELAO=REDONDO
ABACAXI=BOB ESPONJA
MAÇA=VERMELHO
AÇAI=SORVETE
AMORA=FILHA DO MANNY(A ERA DO GELO)
ABACATE=CAROÇO
CACAU=CHOCOLATE
CARAMBOLA=ESTRELA
CACHORRO=ANIMAL
PRATO=COZINHA
LIMAO=VERDE
RADIO=MUSICA
CHAO=PISAR
CHURRASCO=FUMAÇA
PAREDE=CASA
GARFO=COMER
DISNEY=MICKEY
MOTOBOY=DELIVERY
CORONA=CERVEJA
SACOLA=PLASTICO
MEIA=PAR 
FUTEBOL=COPA DO MUNDO
NOITE=LUA
DIA=SOL 
ORQUESTRA=CONCERTO
POLICIA=LADRAO
PINKFLOYD=BANDA ROSA
BARBA=HOMEM
FORMULAUM=FERRARI
PIJAMA=DORMIR
FRIENDS=MAIS QUE AMIGOS
PULAR=CORDA
PORCO=LINGUIÇA 
LAMPADA=ILUMINAR
PAMONHA=MILHO
AÇOUGUE=CARNES
TULIPA=FLOR
QUADRO=FOTOS
HAMBURGUER=LANCHONETE
PRAIA=FERIAS
LENÇOL=COLCHÃO
AQUARIO=PEIXE
AVIAO=VIAGEM
LEAO=FLORESTA
ACAMPAMENTO=BARRACA
PENTE=CABELO
ESMALTE=UNHA
MOLETOM=FRIO
GELADEIRA=GELO